2 2 2 2 2 2 2 2 2 2 2 2 2 2 2 2
2 1 1 1 1 1 1 1 1 1 1 1 1 1 1 2
2 1 1 1 1 1 1 1 1 1 1 1 1 1 1 2
2 1 2 2 2 2 2 2 2 2 2 2 2 1 1 2
2 1 2 1 1 1 1 1 1 1 1 1 2 1 1 2
2 1 2 1 1 1 1 1 1 1 2 1 2 1 1 2
2 1 2 2 2 2 2 2 2 2 2 1 2 1 1 2
2 1 1 1 1 1 1 1 1 1 1 1 2 1 1 2
2 2 2 2 2 2 2 2 2 2 2 2 2 1 1 2
2 1 1 1 1 1 1 1 1 1 1 1 1 1 1 2
2 1 1 1 1 1 1 1 1 1 1 1 1 1 1 2
2 2 2 2 2 2 2 2 2 2 2 2 2 2 2 2
11
0 2 8
2 15 10
2 15 1
2 1 2
2 7 1
2 7 11
1 3 5
1 5 4
1 7 5
4 8 0
5 1 1
7 3 4 6