2 2 2 2 2 2 2 2 2 2 2 2 2 2 2 2
2 1 1 1 1 1 2 1 1 1 1 1 1 1 1 2
2 1 1 1 1 1 2 1 1 1 1 1 1 1 1 2
2 1 1 1 1 1 2 2 2 2 1 1 1 1 1 2
2 1 1 1 2 1 1 2 2 2 2 1 1 1 1 2
2 1 1 1 2 1 1 1 2 2 2 2 1 1 1 2
2 1 1 1 2 1 1 1 1 1 2 2 2 1 1 2
2 2 2 2 2 1 2 2 1 1 1 2 2 1 1 2
2 1 1 1 2 1 1 2 2 1 1 1 1 1 1 2
2 1 1 1 1 1 1 1 2 2 1 1 1 1 1 2
2 1 1 1 1 1 1 1 1 2 1 1 1 1 1 2
2 2 2 2 2 2 2 2 2 2 2 2 2 2 2 2
9
0 2 8
1 5 9
1 3 3
1 12 2
1 12 9
4 8 0
6 2 5
5 1 1
7 12 1 5