2 2 2 2 2 2 2 2 2 2 2 2 2 2 2 2
2 1 1 1 1 1 1 1 1 1 1 1 1 1 1 2
2 2 2 2 2 2 2 1 1 2 2 2 2 2 2 2
0 0 0 0 0 0 2 1 1 2 0 0 0 0 0 0
2 2 2 2 2 2 2 1 1 2 2 2 2 2 2 2
2 1 1 1 1 1 1 1 1 1 1 1 1 1 1 2
2 2 2 2 2 2 2 1 1 2 2 2 2 2 2 2
0 0 0 0 0 0 2 1 1 2 0 0 0 0 0 0
2 2 2 2 2 2 2 1 1 2 2 2 2 2 2 2
2 1 1 1 1 1 1 1 1 1 1 1 1 1 1 2
2 2 2 2 2 2 2 1 1 2 2 2 2 2 2 2
0 0 0 0 0 0 2 3 3 2 0 0 0 0 0 0
7 9
8
3 2 1 14 1
3 14 5 2 5
3 1 9 14 9
3 7 1 7 10
2 14 1
4 12 0
6 1 5
5 1 1
