2 2 2 2 2 2 2 2 2 2 2 2 2 2 2 2
2 1 1 1 1 1 1 1 1 1 1 1 1 1 1 2
2 1 1 1 1 1 1 1 1 1 1 1 1 1 1 2
2 1 2 2 2 2 2 2 2 2 2 2 2 1 1 2
2 1 2 1 1 1 1 1 1 1 1 1 2 1 1 2
2 1 2 1 1 1 1 1 1 1 2 1 2 1 1 2
2 1 2 2 2 2 2 2 2 2 2 1 2 1 1 2
2 1 1 1 1 1 1 1 1 1 1 1 2 1 1 2
2 2 2 2 2 2 2 2 2 2 2 2 2 1 1 2
2 1 1 1 1 1 1 1 1 1 1 1 1 1 1 2
2 1 1 1 1 1 1 1 1 1 1 1 1 1 1 2
2 2 2 2 2 2 2 2 2 2 2 2 2 2 2 2
2 8
11
2 14 10
2 14 1
2 1 2
2 7 1
2 7 10
1 3 5
1 5 4
1 7 5
4 8 0
5 1 1
7 3 4 6